0000000000000000000
0000000000000000000
0000000000000000000
0000012220000000000
0000012220000010000
0000012220000010000
0000010000000010000
0000010060000010000
0000010000000000000
0000010000000000000
0000000000000000000
0000000000000000000
0000000001100000000
0000000001000000000
0000000001000000000
0000000001000111111
0000000001000100000
1111000000000100000
0000000000000100000
0000000000000100000
0000000010000100000
0000000010000100000
0000000010000100000
0000000010000100000
3000000010000000000
3300000000000000000
3330000000000000000
3300000000000000000
3000000000111111111
0000000000122200000
0000010000122000000
0000010000120000000
0000010000100000000
0000010000100000000
0000010000100000000
0000010000000000000
0000010000000000000
0000000000000000000
0000000000000000000
0006000110000000000
0000001100000000000
0000011000000000000
0000110000000000000
0000100000000000000
1111100000000000000
0000000000000000000
0000000000000000000
