1111111111110000000
1111111111100000000
1111111111000000000
1111111110000000000
1111111100000000000
1111111000000000000
1111110000000000000
1111100000000000000
1111000000000000000
1110000000000000000
1100000000000000000
1000000000000000000
0000000010000000000
0000000010006000000
0000000010000000000
0000000010000000000
0000000010000100000
0000000010000100000
0000000010000100000
0000000010000100000
0000000010000100000
0000000010000100000
0000000010000100000
0000000010000100000
0000000010000100000
0000000010000100000
0000000010000100000
0000000010000100000
0000000010000100000
0000000010000100000
0000000010000100000
0000000010000000000
0000000010000000000
0000000010006000000
0000000010000000000
1000000000000000000
1100000000000000000
1110000000000000000
1111000000000000000
1111100000000000000
1111110000000000000
1111111000000000000
1111111100000000000
1111111110000000000
1111111111000000000
1111111111100000000
1111111111110000000
