1111220000001000000
1111200000001000000
1111000600001001000
1110000000001111000
1100000000001001000
1000000000001000000
0000000100001000000
0000000100001000000
0000000100000000000
0000000100000000000
0000000100000000000
0000000100000000000
3000000000000000000
3300000000001000000
3330000000001000000
3330000000001000000
3330000000001000000
0000000000001000000
0000000000000000000
0000000000000000000
0000000001000000000
0000000001000000000
2000000001000000000
2200000001000000000
2000000001000001000
0000000001000001000
0000000001000001000
0000000001000000000
0000000000000000000
0000000000000000000
3330000000000100000
3330000000000100000
3330000000000100000
3300000000000100000
3000000000000100000
0000000000000100000
0000000010000000000
0000000010000000000
0000000012000060000
0000000012200000000
0000000012000000000
1000000010000000000
1100000000000000000
1110000000000000000
1111000000000000000
1111200000000000000
1111220000000000000
